ryanreynolds	ryan rey nolds
bape	bape
intaphoto	inta photo
benleck	ben leck
August29	August29
parties	parties
TERA	T ER A
DodgerBlue	Dodger Blue
Legian	Legian
MacAir	Mac Air
Taylord	Taylord
cplt2013	cplt 2013
solucky	so lucky
1DFRAGANCE	1D FR AGA NC E
TheDesertRose	The Desert Rose
MAGNIFICENT	MAGNIF ICEN T
BestVine	Best Vine
TheStig	The Stig
F12013	F12013
instageek	insta geek
iggy	iggy
hugs	hugs
Clois	Clois
iphonography	iphonography
WarwickProbs	Warwick Probs
notconvinved	not convinved
blackpower	black power
Crushes	Crushes
ChemicalWeapons	Chemical Weapons
ghostbusters	ghost busters
MIRANDAKERR	MIR ANDAKER R
Attention	Attention
9NewsMornings	9 News Mornings
3rdtimesacharm	3rdtime s acharm
mandarinenapoleon	mandarine na poleon
damonismyfave	damon is my fave
putyouupongame	put you upon game
fallen	fallen
tooshort	too short
littlegirle	little girle
pastries	pastries
buzzzing	buzzzing
youwillpay	you will pay
heehee	heehee
ontothenext	on to the next
storythursday	story thursday
monologues	monologues
wordofmouth	word of mouth
looksoreal	look so real
anythingcanhappen	anything can happen
rickytherockstar	ricky the rockstar
seaside	seaside
heartbreakinglines	heart breaking lines
itweetfeeds	i tweet feeds
buenamusic	buena music
cheerstosoccer	cheers to soccer
tenminutetakeover	ten minute takeover
motivated	motivated
frominjury	from injury
yourabadass	your abadass
inthehouse	in the house
GoAngels	Go Angels
dwot	dwot
GoGoVettel	Go Go Vettel
LeeNorris	Lee Norris
CornettoForever	Cornet to Forever
STATE	ST AT E
Sessions	Sessions
PeterPan	Peter Pan
independenceday	independence day
juicyj	juicy j
hangoverthemovie	hang over the movie
extensions	extensions
pieitforward	pie it forward
1Dtoday	1D today
AnywayYouWantIt	Anyway You Want It
SCtweets	S Ctweets
SoVeryVeryLonely	So Very Very Lonely
poorkid	poor kid
nofilters	no filters
stackedgroup	stacked group
opencity	open city
greatestdad	greatest dad
convinced	convinced
annapolis	annapolis
hashtagYEAH	hashtag YEA H
LiberalLogic	Liberal Logic
BigSpoon	Big Spoon
BrickRSS	BrickRS S
Rings	Rings
someonesneakmein	someone s neak me in
digiornogameday	digior no gameday
NEWUPDATE	NE WUPD AT E
carrotdays	carrot days
FedGovt	Fed Govt
KnuffelOfZoen	Knuffel Of Zoen
PRAYFORBALE	PRAYF ORBAL E
MaxFoster	Max Foster
instagrams	instagrams
Coolpix	Coolpix
RALLYBLUETEAM	RALL YBLU ETEA M
Foot	Foot
hologram	hologram
Waikiki	Waikiki
ASLsportsgroup	AS Lsportsgroup
MalagaCF	MalagaC F
KellyOsbourne	Kelly Osbourne
lifemade	life made
FIFA13	FIFA13
bailout	bailout
cafnation	cafnation
Loser	Loser
nobel	nobel
Ciara	Ciara
keepcalm	keep calm
6monthspregnent	6 months pregnent
shoeaddict	shoe addict
DAYS	DAY S
cricket	cricket
christianbale	christian bale
clinton	clinton
Vanquish	Vanquish
GeneRoddenberry	Gene Roddenberry
tryingtosleep	trying to sleep
mixture	mixture
runit	run it
whatadream	what a dream
keepitcoming	keep it coming
originalman	original man
sportsnews	sports news
onrepeat	on repeat
creative	creative
thegrandmaster	the grand master
nicee	nicee
photocontest	photo contest
linux	linux
exactwords	exact words
cursing	cursing
degeneratemedia	degenerate media
powercouple	power couple
factsoflife	facts of life
badatreferences	bad at references
awardshow	award show
cyclists	cyclists
season1episode2	season 1 episode 2
boxervsrain	boxer vs rain
lovewithouttragedy	love without tragedy
inmyopinion	in my opinion
thatsmydaddy	thats my daddy
whatelseisnew	what else is new
privateschoolprobz	private school probz
Deleanorrie	Deleanorrie
Batflack	Bat flack
Mikey	Mikey
Copped	Copped
NextMicrosoftCEO	Next Microsoft CE O
longlive	long live
usairways	us airways
Hoodrat	Hoodrat
FINALLY	FIN A LL Y
heronrine	heron rine
TheDuo	The Duo
heartless	heartless
CastleonTNT	CastleonT N T
Espana	Espana
YouHitItFirst	You Hit It First
noideawhy	no idea why
7thSeptember	7th September
SyawalJuga	Syawal Juga
RootyQ	Rooty Q
corn	corn
dingdingding	ding dingding
BeatLA	BeatL A
ThatsAttractive	Thats Attractive
syrian	syrian
AmWriting	Am Writing
Have	Have
NSAplz	NS Aplz
emblem3	emblem 3
WEATHERDELAYS	WEATHERD ELAY S
booktrailer	book trailer
DailyFantasy	Daily Fantasy
NewYorkGiants	New York Giants
keeppounding	keep pounding
Reporter	Reporter
Hillary2016	Hillary 2016
Falcons	Falcons
RobertDeNiro	Robert De Niro
Auspol	Auspol
Etsy	Etsy
LakeHouse	Lake House
everyoneknowsthis	everyone knows this
Lumens	Lumens
MonaNelsonTrial	Mona Nelson Trial
DUCKFACE	DU CKF AC E
TheFinalCut	The Final Cut
WhatALadYouAre	What A Lad You Are
AlwaysOn	Always On
sorrygirls	sorry girls
ThinkOutOfTgeBox	Think Out OfTge Box
BetterCallSaul	Better Call Saul
GetDunkedon	Get Dunkedon
waldoiscool	waldo is cool
joemacintosh	joe macintosh
pandoraonpointtho	pandoraon point tho
workisdeath	work is death
jaimelovesstuff	jaime loves stuff
SmallBusiness	Small Business
Doggie	Doggie
ANTMBritshInvasion	A NT M Britsh Invasion
nano	nano
RosebarDayParty	Rosebar Day Party
willpower	will power
favoritebook	favorite book
NoDaysOff	No Days Off
Bruce2Wpg	Bruce2 Wpg
GimmeGimmeGimme	Gimme Gimme Gimme
bankhoilday	bank hoil day
MomProblems	Mom Problems
Shakeology	Shakeology
Comicmarket	Comic market
PixieInfinity	Pixie Infinity
MercuryRetrograde	Mercury Retrograde
AnziMakha	Anzi Makha
amazingLoveThem	amazing Love Them
overachiever	overachiever
castingfailure	casting failure
dontbeafraud	dont be a fraud
NeverBeenHurt	Never Been Hurt
SuperGuy	Super Guy
pink	pink
brunobanani	bruno banani
bearsoffense	bears offense
katemoss	kate moss
anklebreak	anklebreak
Luck	Luck
EndChildhoodHunger	End Childhood Hunger
transfers	transfers
roundandround	round and round
ChicagoBears	Chicago Bears
BestFriends	Best Friends
PresidentPaul	President Paul
onceUponAtime	once Upon A time
tfwcancun	tfw cancun
Viral2013	Viral2013
stayhomevoters	stay home voters
sleepless	sleepless
Movieshttp	Movies http
LoveDemi	Love Demi
Examinercom	Examinercom
knickstape	knickstape
GetWellSoonPiers	Get Well Soon Piers
buffet	buffet
wherearetheynow	where are they now
artpopladygaga	artpoplady gaga
chelsealately	chelse a lately
lokeitup	loke it up
KingsIsland	Kings Island
Hotcards	Hot cards
SandonFollowParty	Sandon Follow Party
grosseclasse	grosse classe
Forver21	Forver 21
edcampdetroit	edcamp detroit
PRESIDENCY	PRESIDE NC Y
sanchezproblems	sanchez problems
getresults	get results
Vaccination	Vaccination
leabianlovers	leabian lovers
mickey	mickey
babygate	baby gate
ItsDifferentLevels	Its Different Levels
Marrakesh	Marrakesh
secondamendment	second amendment
stopthecycle	stop the cycle
paniniamerica	panini america
AIRPLANE	A IRPLAN E
MeadowsMall	Meadows Mall
onlinebusiness	online business
celebration	celebration
BieberFever	Bieber Fever
nashvilleskyline	nashvilleskyline
AboutABoy	About A Boy
halleberry	halleberry
bengomori	bengomori
AndChocolate	And Chocolate
playas1	playas 1
Snowdenyes	Snow denyes
peaceouthomefries	peace out home fries
blackfacts	black facts
RoadToRecovery	Road To Recovery
NeutronCream	Neutron Cream
Numer1DraftPick	Numer1 Draft Pick
andalucia	and alucia
AmericaTonight	America Tonight
neocon	neocon
afghanistan	afghanistan
mygrounded	my grounded
GoTeamCute	Go Team Cute
LoveThis1	Love This1
thuglifetho	thug life tho
SomethingBorrowed	Something Borrowed
idiedlaughing	i died laughing
screenminecraft	screen minecraft
BestInSports	Best In Sports
BostonTrolls	Boston Trolls
Callofdutymagic	Call ofdutymagic
Bellahouston	Bellahouston
BLUEJAYS	BLU EJAY S
lesh	lesh
TeamInsaneRetards	Team Insane Retards
goatrance	goatrance
urology	urology
PrayForNikki	Pray For Nikki
GalaxyNexus	Galaxy Nexus
Foto	Foto
kimbracover	kimbra cover
Holygrail	Holy grail
MySavingGrace	My Saving Grace
REPUBS	REPUB S
waletop5	wale top 5
JayRyan	Jay Ryan
SubliminalMessaging	Subliminal Messaging
Services	Services
part2	part 2
Pinkslips	Pinkslips
Cherylknows	Cherylknows
iAteTheBones	i Ate The Bones
Price	Price
CultOfPersonality	Cult Of Personality
gottahotdate	gotta hot date
NikeRunning	Nike Running
leightonmeester	leighton meester
MetalGearSolid	Metal Gear Solid
sodone	so done
educatedfirefighter	educated fire fighter
anythinghelps	anything helps
Squamish	Squamish
mynameisjudge	my name is judge
IceCube	Ice Cube
winningfortheyear	winning for the year
playoffrush	play of frush
radiodasantigas	radio da san tigas
SouthlandTales	Southland Tales
waititsnotfriday	wait its not friday
hopefully	hope fully
BYP100	BY P100
brnoseries	brno series
MusicSpotlight	Music Spotlight
IfIWereOnGreys	If I Were On Greys
peoplearelooking	people are looking
SparksStreet	Sparks Street
AnnaKendrickLamar	Anna Kendrick Lamar
Democracy	Democracy
quotesaboutlove	quotes about love
keepsmeoccupied	keeps me occupied
Campello	Campello
perfecter	perfecter
youjelly	you jelly
Beehive	Beehive
hamsterface	hamster face
insurgent	in surgent
thefirerises	the firerises
10RANDOMACTS	10RANDOMACT S
idisappointmyself	i disappoint myself
SoMuchHair	So Much Hair
Jcrew	Jcrew
Absolution	Absolution
nopuffinseen	no puffinseen
Bibi	Bibi
skeptisk	skeptisk
Batleck	Batleck
Cheerleading	Cheerleading
newstome	news tome
slowservice	slow service
BigLove	Big Love
greencard	green card
SnowdenThe	Snowden The
LoveANTM	Love A NT M
aleshadixon	alesha dixon
funda	funda
combination	combination
bittersweet	bittersweet
pharrell	pharrell
PHONE	PH ON E
GiantsMobile	Giants Mobile
Senior2014	Senior 2014
feed	feed
meredith	meredith
multifucked	multi fucked
Topgear	Top gear
im12	im 12
GOOGLEPLAY	GOOGL EPLA Y
amazingjob	amazing job
needle	needle
PCGames	PC Games
swing	swing
WEBEAST	WE BE AS T
AlphaScott	Alpha Scott
dreamon	dreamon
makeout	make out
soccershoesfetish	soccer shoes fetish
Courage	Courage
Pasikatan2013	Pasikatan2013
BottleShock	Bottle Shock
kktc	kktc
1DMoviesChat	1 D Movies Chat
oksteakcookoff	ok steak cook off
SamIsBack	Sam Is Back
doublexp	doublexp
hateitorloveit	hate it or love it
birdsvilleraces	birdsville races
efffyeah	efffyeah
Tacos	Tacos
assasin	assasin
gummybears	gummy bears
Classof2014	Classof 2014
direct	direct
uglyskank	ugly skank
Cabaret	Cabaret
iamthedanger	i am the danger
birth	birth
4thReichrising	4th Reichrising
Kisskiss	Kisskiss
OprahOscar	Oprah Oscar
harry1d	harry 1d
RIPKANYE	RIPKANY E
niggas	niggas
easilyamused	easily amused
instagram	instagram
Roulette	Roulette
NoPlanB	No Plan B
whatsgood	whats good
point	point
LightersUp	Lighters Up
PTSD	PTS D
AlbumCover	Album Cover
Buffywisdom	Buffy wisdom
familyfun	family fun
jan25	jan 25
IdealDay	Ideal Day
pinkfriday	pink friday
22Meet	22 Meet
27Dresses	27 Dresses
sorrybro	sorry bro
shirk	shirk
LOVERS	LOV ER S
ryanreynolds	ryan rey nolds
bape	bape
intaphoto	inta photo
benleck	ben leck
August29	August29
parties	parties
TERA	T ER A
DodgerBlue	Dodger Blue
Legian	Legian
MacAir	Mac Air
Taylord	Taylord
cplt2013	cplt 2013
solucky	so lucky
1DFRAGANCE	1D FR AGA NC E
TheDesertRose	The Desert Rose
MAGNIFICENT	MAGNIF ICEN T
BestVine	Best Vine
TheStig	The Stig
F12013	F12013
instageek	insta geek
iggy	iggy
hugs	hugs
Clois	Clois
iphonography	iphonography
WarwickProbs	Warwick Probs
notconvinved	not convinved
blackpower	black power
Crushes	Crushes
ChemicalWeapons	Chemical Weapons
ghostbusters	ghost busters
MIRANDAKERR	MIR ANDAKER R
Attention	Attention
9NewsMornings	9 News Mornings
3rdtimesacharm	3rdtime s acharm
mandarinenapoleon	mandarine na poleon
damonismyfave	damon is my fave
putyouupongame	put you upon game
fallen	fallen
tooshort	too short
littlegirle	little girle
pastries	pastries
buzzzing	buzzzing
youwillpay	you will pay
heehee	heehee
ontothenext	on to the next
storythursday	story thursday
monologues	monologues
wordofmouth	word of mouth
looksoreal	look so real
anythingcanhappen	anything can happen
rickytherockstar	ricky the rockstar
seaside	seaside
heartbreakinglines	heart breaking lines
itweetfeeds	i tweet feeds
buenamusic	buena music
cheerstosoccer	cheers to soccer
tenminutetakeover	ten minute takeover
motivated	motivated
frominjury	from injury
yourabadass	your abadass
inthehouse	in the house
GoAngels	Go Angels
dwot	dwot
GoGoVettel	Go Go Vettel
LeeNorris	Lee Norris
CornettoForever	Cornet to Forever
STATE	ST AT E
Sessions	Sessions
PeterPan	Peter Pan
independenceday	independence day
juicyj	juicy j
hangoverthemovie	hang over the movie
extensions	extensions
pieitforward	pie it forward
1Dtoday	1D today
AnywayYouWantIt	Anyway You Want It
SCtweets	S Ctweets
SoVeryVeryLonely	So Very Very Lonely
poorkid	poor kid
nofilters	no filters
stackedgroup	stacked group
opencity	open city
greatestdad	greatest dad
convinced	convinced
annapolis	annapolis
hashtagYEAH	hashtag YEA H
LiberalLogic	Liberal Logic
BigSpoon	Big Spoon
BrickRSS	BrickRS S
Rings	Rings
someonesneakmein	someone s neak me in
digiornogameday	digior no gameday
NEWUPDATE	NE WUPD AT E
carrotdays	carrot days
FedGovt	Fed Govt
KnuffelOfZoen	Knuffel Of Zoen
PRAYFORBALE	PRAYF ORBAL E
MaxFoster	Max Foster
instagrams	instagrams
Coolpix	Coolpix
RALLYBLUETEAM	RALL YBLU ETEA M
Foot	Foot
hologram	hologram
Waikiki	Waikiki
ASLsportsgroup	AS Lsportsgroup
MalagaCF	MalagaC F
KellyOsbourne	Kelly Osbourne
lifemade	life made
FIFA13	FIFA13
bailout	bailout
cafnation	cafnation
Loser	Loser
nobel	nobel
Ciara	Ciara
keepcalm	keep calm
6monthspregnent	6 months pregnent
shoeaddict	shoe addict
DAYS	DAY S
cricket	cricket
christianbale	christian bale
clinton	clinton
Vanquish	Vanquish
GeneRoddenberry	Gene Roddenberry
northbeach	north beach
defundobamacare	defund obamacare
Ligue1	Ligue1
PLLfinaleFever	PL Lfinale Fever
glees5	glees 5
selgomez	selgomez
onairoops	onairoops
billsmafia	bills mafia
streaming	streaming
instaperfect	instaperfect
blinded	blinded
fridaynight	friday night
RyanBraun	Ryan Braun
Update	Update
Hotel	Hotel
snakeskin	snake skin
cast	cast
standunited	stand united
ViggleTV	ViggleT V
TomHaverford	Tom Haverford
AfterParty	After Party
breakingbadsunday	breaking bad sunday
gonnaregretit	gonna regret it
UnClassique	Un Classique
worldcinema	world cinema
needaskypechat	need a skypechat
womanbeater	woman beater
SHARAPOVA	SH AR AP OV A
LocalEvents	Local Events
CoreyHaim	Corey Haim
PRESIDENT	PRES IDEN T
goddamn	god damn
pukkamovie	pukka movie
Fume	Fume
MonsterLove	Monster Love
DalaranEvent	Dalaran Event
Annuity	Annuity
trey	trey
celticfc	celtic fc
TrueHoss	True Hoss
alwaysloving	always loving
notaboutthatlife	not about that life
darthmaul	darth maul
whosline	whos line
edmcentral	edm central
Wiltshire	Wiltshire
backinyourarms	back in your arms
TwoYearsOfWMYB	Two Years Of WMY B
thekilling	the killing
DesignLuxChat	Design Lux Chat
Hillarious	Hillarious
Squadddddddd	Squadddddddd
Mataria	Mataria
biggest	biggest
hotnerd	hot nerd
yiewwww	yiewwww
LeadRole	Lead Role
Testing	Testing
recognized	recognized
summerstruggle	summer struggle
luuuuuke	luuuuuke
instantreplays	instant replays
pencils	pencils
traffikgroup	traffik group
shefine	she fine
imnotcrazy	im not crazy
guyprobs	guy probs
been2long	been 2 long
skooliz4foolz	skooliz 4 foolz
backtoherroots	back to her roots
behavior	behavior
newapartment	new apartment
goldenballs	golden balls
german	german
authorities	authorities
projectcatchup	project catchup
yeahyeahyeahs	yeah yeah yeahs
f1junkie	f1 junkie
whaaaaat	whaaaaat
byrdistheword	byrd is the word
creeps	creeps
nowifi	no wifi
archaeological	archaeological
sendhewyhisshoes	sendhewy his shoes
myfirstgame	my first game
GeorgeDavis	George Davis
doggystylevi	doggy style vi
lendusalive	lend us alive
PLLseason4	PL Lseason 4
zerrie4ever	zerrie 4 ever
countryMusic	country Music
youreout	youre out
whore	whore
Respected	Respected
weaksauce	weak sauce
GoViks	Go Viks
mercedesamgf1	mercedesam gf1
Lasttweet	Last tweet
2009	2009
FETISH	FET IS H
streetart	street art
PaulWesley	Paul Wesley
lovestory	love story
fucked	fucked
SanFranciscoGiants	San Francisco Giants
PRETTYLITTLELIARS	PRETTYLITTLELI AR S
nbaleaguepass	nba league pass
Minecraftsolo	Minecraft solo
GetYaGangstaOn	Get Ya Gangsta On
RedSkinsNation	Red Skins Nation
LetHimGo	Let Him Go
sopeacful	so peacful
TheAudience	The Audience
missedday	missed day
spartacus	spartacus
futuramafry	futura ma fry
liberalguilt	liberal guilt
MarchOn	March On
FEMINISM	FE MINIS M
Mideast	Mideast
louisTomlinson	louis Tomlinson
IBeRich	I Be Rich
BuschGardens	Busch Gardens
ElectronicArts	Electronic Arts
jamesMcavoy	james Mcavoy
TheBestoftheBest	The Best of the Best
Gorgeous	Gorgeous
blowingmymind	blowing my mind
DravetSyndrome	Dravet Syndrome
OriginalBandNames	Original Band Names
shiny	shiny
Microsofthttp	Microsofthttp
StllMilkingIt	Stll Milking It
teenwolftonight	teen wolf tonight
Loveme	Love me
ApplyNow	Apply Now
MeGustasComoPara	Me Gustas Como Para
nerdpower	nerd power
eatgreedy	eat greedy
CanadianKawasaki	Canadian Kawasaki
lovelife	love life
newfavsong	new fav song
TheActofKilling	The Actof Killing
whistleblowers	whistle blowers
NvidiaShield	Nvidia Shield
Uplifting	Uplifting
BestBoyfriend	Best Boyfriend
pants	pants
GameFebreTeen	Game Febre Teen
NowYouKnow	Now You Know
BrownGate	Brown Gate
G00dmusic	G00d music
blackeye	black eye
safetyshow	safety show
instaturk	instaturk
Gesture	Gesture
GoMarinera	Go Marinera
UNION	UN IO N
wearechicago	we are chicago
Gottabeyou	Gottabe you
osbirdsnest	osbirds nest
kmart	kmart
fortedeimarmi	fortedei marmi
Thea	Thea
BackToBasics	Back To Basics
missthatguy	miss that guy
GoWarriors	Go Warriors
ChickFilA	Chick Fil A
elderly	elderly
lemans	lemans
Hate	Hate
Trugen	Trugen
StagesDay	Stages Day
expressbars	express bars
mitchell	mitchell
goodluckcod	good luck cod
fuqNetFlix	fuq Net Flix
Inauguration	Inauguration
OliviaColman	Olivia Colman
Recording	Recording
emmawatson	emma watson
SaintGeorges	Saint Georges
IHaveNoLife	I Have No Life
10thintheWest	10th in the West
49ershttp	49ers http
futurestartingqb	future starting qb
killforme	kill for me
90smusic	90s music
foodstampfraud	food stampfraud
nothingbutbands	nothing but bands
idchoosehim	id choose him
RooneyforChelsea	Rooney for Chelsea
3cornettos	3 cornettos
mcdreamy	mcdreamy
CBBBOTS	CB BB OT S
duckphillips	duck phillips
Stars2Know	Stars2 Know
hairdied	hairdied
LandoftheLost	Land of the Lost
icecold	ice cold
Heartbreaker	Heartbreaker
TheRiseGuys	The Rise Guys
golewis	go lewis
ChubbyBunny	Chubby Bunny
MorganFreeman	Morgan Freeman
DAMN	DAM N
Kamloops	Kamloops
SurveillanceState	Surveillance State
bums	bums
Ewwww	Ewwww
kungfu	kungfu
military	military
forbes	for bes
LeanIn	Lean In
publishing	publishing
BRONCOS	BR ONCO S
noquicksolution	no quick solution
myyyyyNEEEE	myyyyy NEEE E
FREEQUEST	FREE QUES T
TRANCEFAMILY	TR ANCEFAMIL Y
LIKEforLIKE	LIK EforL IK E
cancoke	can coke
BERLUSCONI	BERLUSC ON I
BLESSED1	BLESSE D1
conceptiphone	concept iphone
haute	haute
sneakerfiles	sneaker files
forevertired	forever tired
specialfood	special food
idhangonthat	id hang on that
amillionhoodies	a million hoodies
minecraf	mine craf
ourmomentfragrance	our moment fragrance
waybackwhen	way back when
dontchewthegum	dont chew the gum
FernandoTorres	Fernando Torres
shootme	shoot me
watchfreetv	watch free tv
shebasic	she basic
roomates	roomates
CONGRATS	CO N GR AT S
Dunk	Dunk
aamirkhan	aamirkhan
SailfishOS	SailfishO S
Fangirl	Fangirl
batfleck	bat fleck
SwineFest	Swine Fest
10todayshow	10 today show
Kimi	Kimi
youtuber	youtuber
NewNJGunLaws	New NJ Gun Laws
rageofbahamut	rage of bahamut
president	president
phone	phone
Kobo	Kobo
AlQaeda	Al Qaeda
askrichard	ask richard
sohot	so hot
UTSA17	UTS A17
chanelbag	chanel bag
1999	1999
DeanWinchester	Dean Winchester
ADIDAS	AD IDA S
MovieReview	Movie Review
ipodtouch	ipod touch
PuertoRico	Puerto Rico
marathon	marathon
Flames	Flames
Blessed	Blessed
top5	top 5
Starbucks	Starbucks
AskGatsby	Ask Gatsby
Tsarnaev	Tsarnaev
Loud	Loud
GGCTransforms	GGC Transforms
FreeBG	Free B G
VIDEO	VIDE O
Lake	Lake
three	three
Bangalore	Bangalore
eossipov	eossipov
trailblazers	trail blazers
legionella	legionella
chiropractic	chiropractic
DexterMorgan	Dexter Morgan
maternity	maternity
badvsgood	bad vs good
TheRoots	The Roots
PabloArmy	Pablo Army
SongsForVlad	Songs For Vlad
wishitwasreal	wish it was real
inlovewith1D	in love with1 D
Geeklove	Geek love
TEAMRONSAM	TEA MR ONSA M
Quran	Quran
biaaaach	biaaaach
fangtasyisland	fangtasy island
videooftheday	video of the day
rafsimons	rafsimons
permaculture	perma culture
keepup	keep up
BestManForTheJob	Best Man For The Job
then	then
Troubledman	Troubledman
WeOutChea	We Out Chea
gimmemore	gimme more
DelayedTweet	Delayed Tweet
justbecause	just because
Belguim	Belguim
scrimmage	scrimmage
BodyRockGang	Body Rock Gang
finallysomesense	finally somesense
BakerMotorCompany	Baker Motor Company
NotShocked	Not Shocked
teammercedesamg	team merce desamg
pic3	pic 3
traumitised	traumitised
LetsEat	Lets Eat
ColdWeather	Cold Weather
ToastToTennis	Toast To Tennis
Greysonfact	Greyson fact
DallasMavs	Dallas Mavs
Gallagher	Gallagher
superbowlBOUND	superbowl BOUN D
RichardMadden	Richard Madden
italian	italian
spartanmove	spartan move
thumbscannerwhat	thumbs canner what
ImageAmplified	Image Amplified
USPS	USP S
muslimahpride	muslimah pride
badmorning	bad morning
minecrafthouses	minecraft houses
livegatsby	live gats by
faceoffsyfy	face off syfy
gearz	gearz
ultra	ultra
bluntvilles	bluntvilles
ahmazing	ahmazing
nobodytoldme	nobody told me
dontmesswithtexas	dont mess with texas
rodolfo	rodol fo
crispyduckbali	crispy duck bali
ChexterForever	Chexter Forever
sunydownstate	suny down state
canthelpmyself	cant help myself
SelfMotivatedDude	Self Motivated Dude
Goowap	Goowap
schnauzergang	schnauzergang
craigcharles	craig charles
piggy	piggy
AidanTurner	Aidan Turner
Minds	Minds
RCTLesMis	RCT Les Mis
PrayForRoscoe	Pray For Roscoe
EPLUpdates	EPL Updates
WheresSheldon	Wheres Sheldon
MyGlory	My Glory
PLLfamily	PL Lfamily
Darkside	Darkside
favefilm	fave film
DaDaDa	Da Da Da
MuchLoveForTHREE	Much Love ForT HRE E
ThatisAll	That is All
bowiefriday	bowie friday
allaccess	all access
5winsinarow	5 winsin arow
Fitcode	Fitcode
excitedddddddd	excitedddddddd
ohmygerd	oh my gerd
beardgang	beard gang
PORTUGAL	PORTUGA L
Hamster	Hamster
wbbw	wbbw
beanbath	bean bath
AsRoma	As Roma
Lenny	Lenny
GoArrows	Go Arrows
EgoMaxwell	Ego Maxwell
JobstheFilm	Jobs the Film
xula	xula
RIGHT	RIGH T
Harryscode	Harrys code
90sareback	90s are back
againstallodds	againstallodds
bigdeal	big deal
wolfies	wolfies
wherearethegays	where are the gays
conetto	conetto
fantasyproblems	fantasy problems
3classesaday	3 classes a day
misleading	misleading
baseballismylife	baseball is my life
whatisthepoint	what is the point
w00t	w00t
careerinit	careerin it
vocalsandverses	vocals and verses
onmyface	on my face
tenshi	tenshi
nooootttttt	nooootttttt
noluck	no luck
policebike	police bike
goldandred	gold and red
sleepadvantage	sleep advantage
season6ep7	season 6ep 7
the411ladies	the 411 ladies
brekkytreat	brekky treat
flashsale	flash sale
waitforthesiren	wait for the siren
palabra	palabra
heavenly	heavenly
shakthar	shak thar
dancetime	dance time
nexttopgames	next top games
betterthanlost	better than lost
latenites	late nites
forgetgodmode	forget god mode
somuchfood	so much food
geekmom	geek mom
andreus	andreus
neverrealisedit	never realised it
carepackage	care package
blondie	blondie
starbucksing	starbuck sing
debtceiling	debt ceiling
dogville	dog ville
superstars	super stars
youareadumbass	you are a dumbass
newcast6e	new cast6e
javajunkie	java junkie
familytrippy	family trippy
